NO ./textures/matrix.xpm
SO ./textures/matrix.xpm
WE ./textures/matrix.xpm
EA ./textures/img/wall.xpm

F 0,0,0
C 0,0,0

1111111
1000001
1001001
1011101
1001001
1W00001
1111111
