NO ./textures/wolfenstein/blue_stone.xpm
SO ./textures/wolfenstein/eagle.xpm
EA ./textures/wolfenstein/grey_stone.xpm
WE ./textures/wolfenstein/mossy.xpm

F 111,111,111
C 222,222,222

111111  111111      111111  111111
100001  100001      100001  100001
100001  100001      100001  100001
100001  100001      100001  100001
1000011110000111111111000111100011
100000000000010000001110001100011
1000000000000000N000000000000011
1000000000000100000011111000011
100001111000011111111   100001
100001  100001          100001
100001  100001          100001
100001  100001          100001
111111  111111          111111
