NO ./textures/wolfenstein/blue_stone.xpm
SO ./textures/wolfenstein/eagle.xpm
EA ./textures/wolfenstein/grey_stone.xpm
WE ./textures/wolfenstein/mossy.xpm

F 111,111,111
C 222,222,222

111111111111111111111   111111111111111111111
100000000000000000001   100000000000000000001
100000000000000000001   100000000000000000001
111111111000011111111   100001111111111111111
        100001          100001
        100001  111111  100001
        1000011110000111100001
        1000000000E00000000001
        1000011110000111100001
        100001  111111  100001
11111111100001          100001111111111111111
10000000000001          100000000000000000001
10000000000001          100000000000000000001
11111111111111          111111111111111111111
