NO ./textures/img/wall.xpm
SO ./textures/img/wall2.xpm
WE ./textures/img/wall3.xpm
EA ./textures/img/wall4.xpm

F 125,125,125
C 10,10,225

11111
10001
10N01
10001
11111
