NO ./textures/test/north.xpm
SO ./textures/test/south.xpm
WE ./textures/test/west.xpm
EA ./textures/test/east.xpm

F 125,125,125
C 10,10,225

11111
10001
10101
10W01
11111
