NO ./textures/img/wall.xpm
SO ./textures/img/wall.xpm
WE ./textures/img/wall.xpm
EA ./textures/img/wall.xpm

F 111,111,111
C 222,243,255

        1111111111111111111111111
        1000000000000000000000001
        1100000000000000000000001
        1000000000000000000000001
111111111000000000000000000000001
10000N000000010000000000000011111
10000000000001010000000000001
11111111100001000000000000001
10000000000000000000000000011
10000000000000000000000000001
10000000000000000001010000001
11000001110101011111011110101
11110111 1110111 101111010001
11111111 1111111 111111111111
