NO ./textures/test/north.xpm
SO ./textures/test/south.xpm
WE ./textures/test/west.xpm
EA ./textures/test/east.xpm

F 0,0,255
C 10,10,10

1111111
1000001
1001001
1011101
1001001
10000N1
1111111

