NO ./textures/test/north.xpm
SO ./textures/test/south.xpm
WE ./textures/test/west.xpm
EA ./textures/test/east.xpm

F 0,0,255
C 10,10,10

11111
10001
10N01
10001
11111
