NO ./textures/test/north.xpm
SO ./textures/test/south.xpm
WE ./textures/test/west.xpm
EA ./textures/test/east.xpm

F 0,0,255
C 10,10,10

11111   11111
10001   10001
1000111110001
1000000000001
1110000000111
  100111001
  1001 1001
  100111001
111000S000111
1000000000001
1000111110001
10001   10001
10001   10001
11111   11111
